11111111111111111111111111111111
100000C0000000000000000000000001
100000000100000000C0010000000001
1000000C01000000000001000C000001
100C000001000P000000010000000001
10000000010000000000000000000001
1000000C010001101100000111111111
10000000000001000100000000000001
100000000000010E0100000000000001
11111111111101000101000001111111
10000000000001111101000000000001
10000000000100000001000000000001
10000C00000100000000000000000001
10000000000100000000000000C00001
11111111111111111111111111111111
