111111111111
1C0CP0000001
100000000001
100000EC0001
100000000001
111111111111
